w   ,w   ,w   ,w   ,w   ,w   ,w   ,w   ,w   ,0
w   ,rd  ,rl  ,rl  ,rl  ,rld ,rl  ,rl  ,rl  ,w
w   ,rdr ,pl  ,pr  ,rul ,rdr ,pl  ,pr  ,rul ,w
w   ,rdr ,pl  ,pr  ,rul ,rdr ,pl  ,pr  ,rul ,w
w   ,rdr ,pl  ,pr  ,rul ,rdr ,pl  ,pr  ,rul ,w
w   ,rdr ,pl  ,pr  ,rul ,rdr ,pl  ,pr  ,rul ,w
w   ,rdr ,pl  ,pr  ,rul ,rdr ,pl  ,pr  ,rul ,w
x   ,rlr ,pl  ,pr  ,rul ,rdr ,pl  ,pr  ,rul ,w
e   ,rr  ,rr  ,rr  ,rru ,rr  ,rr  ,rr  ,ru  ,w
w   ,w   ,w   ,w   ,w   ,w   ,w   ,w   ,w   ,w
